XXXXXXXXXXXXXXXXXXXXXXXXXXXXXXXXXXXXXXXXXXXXXXXXXXXXXXXXXXXXXXXXXXXXXXXX
XXXXXXXXXXXXXXXXXXXXXXXXXXXXXXXXXXXXXXXXXXXXXXXXXXXXXXXXXXXXXXXXXXXXXXXX
XXXXXXXXXXXXHXXXXXXXXXXXXXXXXXXXXXXXXXXXXXXXXXXXXXXXXXXXXXXXXXXXXXXXXXXX
XXXXXXXXXXXXXXXHXXXXXXXXXXXXEMDXXXHXEMDXXXXXXSXXXHXXXXXXXXXXXXXXXXXXXXXX
XXXXXXXXXXXHXXHXHXXXXXXXXXHHXXXXHXXXXXXXXXHXXHXHXXXEMDXXXXXXXXXXXXXXXXXX
XXXXXXXXXXXXXHXXXXHXXXHXHXXXXXXXXXXXXXXXHXXHXXXXXHXXXXXXXXXXXXXXXXXXXXXX
GGGGGGGAGGGGGGGGGGAGGGAAAAAAAAAAAAGGGAAGGAAAGGGGGAAAAAGGGGGGGAAGGGAGAGGG