XXXXXXXXXXXXXXXXXXXXXXXXXXXXXXXXXXXX
XXXXXXXXXXXXXXXXXXXXXXXXXXXXXXXXXXXX
XXXXXXXXXXXXXXXXXXXXXXXXXXXXXXXXXXXX
XXXXXXXXXXSXXXXXHHHXXXXXXXXXXXXXXXXX
XXXXHXXXHHHXXXEEXXXXHXXXXXXXXXXXXXXX
XXXHXXXHXXXXDXXXXXXSXXXXXXXXXXXXXXXX
GAGGGGGGGAAAAGGGGGAGAGGGGGGGGGGGGGGG