XXXXXXXXXXXXXXXXXXXXXXXXXXXXXXXXXXXXXXXXXXXXXXXXXXXXXXXXXXXXXXXXXXXXXXXXXXXXXXXXXXXXXXXXXXXXXXXXXXXXXXXXXXXX
XXXXXXXXXXXXXXXXXXXXXXXXXXXXXXXXXXXXXXXXXXXXXXXXXXXXXXXXXXXXXXXXXXXXXXXXXXXXXXXXXXXXXXXXXXXXXXXXXXXXXXXXXXXX
XXXXXXXXXXXXXXXXXXXXXXXXXXXXXXXXXXXXXXXXXXXXXXXXXXXXXXXXXXXXXXXXXXXXXXXXXXXXXXXXXXXXXXXXXXXXXXXXXXXXXXXXXXXX
XXXXXXXXXXXXXXXXXXXXXXXXHXXXXXXXXXXHHXHXXHXHXXXHXXXXXXXXXXXXXXXXHXXXXXXXXXXXXXXXXXXXXXHXXXXXXXXXXXXXXXXXXXXX
XXXXXXXXXXXXXHXXXXXHXXHXXXXXXXHXHXXXXXXXXXXXHHXXXXHXXXEMMDXXXXXXXXXHXXXXXXXXXXXXXXXXXHXHXXXXXXXXXXXXXXXXXXXX
XXXSXXXXXXXHXXXXXHXXXHXXXXHXXHSSSSSXSXXXXXXXXXXXXXXXSXXXXXXXXXXXXHXXXXXXXXXXXXXXXXXXHXXXHXXXXEMDSXXXXXXXXXXX
GGGGGGGGGGGAGGGAGAGGGGGAAAGGGGGGGGGGGGAAAAAAAAAAAAAAGGAAAAGAGGGGGAGGGGGGAGGGGGGGGGGGAAAAAAGGGAAAGGGGGGGGGGGG