XXXXXXXXXXXXXX
XXXXXXXXXBBXXX
XXXXXXXXXBBXXX
XXXXXXXXXBBXXX
XXXXXXXXXBBXXX
XXXXXXXXXBBXXX
XXXXXXXXXBBXXX
XXXXXXXXXBBXXX
GGGGGGGGGGGGGG
TTTTTTTTTTTTTT